{
    "startLevel": [
        [1, 1, 1, 1, 1, 1, 1],
        [1, 1, 1, 0, 1, 1, 1],
        [1, 0, 1, 1, 1, 0, 1],
        [1, 0, 0, 0, 1, 1, 1],
        [1, 1, 1, 1, 1, 1, 1],
        [1, 0, 1, 0, 1, 0, 1],
        [1, 1, 1, 1, 1, 1, 1]
    ],
    "correctLevel": [
        [1, 1, 1, 1, 1, 1, 1],
        [1, 3, 1, 0, 3, 1, 1],
        [1, 0, 1, 1, 1, 0, 3],
        [3, 0, 0, 0, 3, 1, 1],
        [1, 1, 3, 1, 1, 1, 1],
        [3, 0, 1, 0, 1, 0, 1],
        [1, 1, 1, 3, 1, 3, 1]
    ],
    "columnValues" : [2, 1, 1, 1, 2, 1, 1],
    "rowValues" : [0, 2, 1, 2, 1, 1, 2],
    "nameLevel": "Level 1 - 7 x 7"
}
